25,12,
GGGGGGGGGGGGGGGGGGGGGGGGG
GGGGGPPPPPPPPPPPPPPPGGGGG
GGGGGPGGGGGGGGGGGGGPGGGGG
GGGGGPGGGGGGGGGGGGGPGGGGG
GGGGGPGGGGGGGGGGGGGPGGGGG
GGGGGPGGGGGGGGGGGGGPGGGGG
GGGGGPGGGGGGGGGGGGGPGGGGG
GGGGGPGGGGGGGGGGGGGPGGGGG
GGGGGPPPPPPPPPPPPPPPGGGGG
GGGGGGGGGGGGGGGGGGGGGGGGG
GGGGGGGGGGGGGGGGGGGGGGGGG
GGGGGGGGGGGGGGGGGGGGGGGGG,
NNNNNNNNNNNNNNNNNNNNNNNNN
NNNNNNNNNNNNNNNNNNNNNNNNN
NNNNNFNNNNNNNNNNNNNNNNNNN
NNNNNNNNNNNNNNNNNNNNNNNNN
NNNNNNNNNNNNNNNNNNNNNNNNN
NNNNNNNNNNNNNNNNNNNNNNNNN
NNNNNNNNNNNNNNNNNNNNNNNNN
NNNNNNNNNNNNNNNNNNNNNNNNN
NNNNNNNNNNNNNNNNNNNMNNNNN
NNNNNNNNNNNNNNNNNNNNNNNNN
NNNNNNNNNNNNNNNNNNNNNNNNN
NNNNNNNNNNNNNNNNNNNNNNNNN,
20,
180,
330 330 330 330 660 660 660 660 .