50,12,
GGGGGGGGGGGGGGGGGGGGGGGGGGGGGGGGGGGGGGGGGGGGGGGGGG
GGGGGGGGPGGGGGGPGGGGGGGGGGGGGGGGGGGGGGGGGGGGGGGGGG
GGGGGPPPPPPPPPPPPPPPPPPPPPPPPPPPPPTTTTTTTTTTGGGGGG
GGGGGPGGGGGTGGGGGGGPGGGGGGGGGGGGGGGGGGGGGGGTGGGGGG
GGGGGPGGGGGTGGGGGGGPGGGGGGGGGGGGGGGGGGGGGGGTGGGGGG
GGGGGPTTTTTPTTTTTTTPGGGGGGGGGGGGGGGGGGGGGGGTGGGGGG
GGGGGPGGGGGTGGGPGGGPGGGPGGGGPGGGGGPPPPPPPPPPGGGGGG
GGGGGPGGGGGTGGGPGGGPGGGPGGGGPGGGGGPGGGGGGGGGGGGGGG
GGGGGPGGGGGTGGGPGGGPGGGPGGGGPGGGGGPGGGGGGGGPGGGGGG
GGGGGPPPPPPPPPPPPPPPTTTTTTTTTTTTTTPPPPPPPPPPGGGGGG
GGGGGGGGPGGGGGGPGGGGGGGGGGGGGGGPGGGGGGGPGGGGGGGGGG
GGGGGGGGGGGGGGGGGGGGGGGGGGGGGGGGGGGGGGGGGGGGGGGGGG,
NNNNNNNNNNNNNNNNNNNNNNNNNNNNNNNNNNNNNNNNNNNNNNNNNN
NNNNNNNNNNNNNNNNNNNNNNNNNNNNNNNNNNNNNNNNNNNNNNNNNN
NNNNNFNNNMNNNNNNNNNNNNNNNNNMNNNNNNNNNNNNNNNNNNNNNN
NNNNNNNNNNNNNNNNNNNNNNNNNNNNNNNNNNNNNNNNNNNNNNNNNN
NNNNNNNNNNNNNNNNNNNNNNNNNNNNNNNNNNNNNNNNNNNNNNNNNN
NNNNNMNNNNNMNNNNNNNNFNNNNNNNNNNNNNNNNNNNNNNNNNNNNN
NNNNNNNNNNNNNNNNNNNNNNNNNNNNNNNNNNNNNNNNFMNNNNNNNN
NNNNNNNNNNNNNNNNNNNNNNNNNNNNMNNNNNNNNNNNNNNNNNNNNN
NNNNNNNNNNNNNNNNNNNNNNNNNNNNNNNNNNNNNNNNNNNNNNNNNN
NNNNNNNNNNNFNNNNNNNNNNNNNNNNNNNNNNNNNNNNNNNNNNNNNN
NNNNNNNNNNNNNNNNNNNNNNNNNNNNNNNNNNNNNNNNNNNNNNNNNN
NNNNNNNNNNNNNNNNNNNNNNNNNNNNNNNNNNNNNNNNNNNNNNNNNN,
35,
180,
660 660 660 660 660 660 660 660.