50,12,
GGGGGGGGGGGGGGGGGGGGGGGGGGGGGGGGGGGGGGGGGGGGGGGGGG
GGGGGPPPPPPPPPPPPPPPPPPPPPPPPPPPPPPPPPPPPPPPGGGGGG
GGGGGGGGGGGGGGGGGGGGGGGGGGGGGGGGGGGGGGGGGGGGGGGGGG
GGGGGPPPPPPPPPPPPPPPPPPPPPPPPPPPPPTTTTTTTTTTGGGGGG
GGGGGPGGGGGTGGGGGGGPGGGGGGGGGGGGGGGGGGGGGGGTGGGGGG
GGGGGPTTTTTPTTTTTTTPGGGGGGGGGGGGGGGGGGGGGGGTGGGGGG
GGGGGPGGGGGTGGGPGGGPGGGPGGGGPGGGGGPPPPPPPPPPGGGGGG
GGGGGPGGGGGTGGGPGGGPGGGPGGGGPGGGGGPGGGGGGGGGGGGGGG
GGGGGPGGGGGTGGGPGGGPGGGPGGGGPGGGGGPGGGGGGGGPGGGGGG
GGGGGPPPPPPPPPPPPPPPTTTTTTTTTTTTTTPPPPPPPPPPGGGGGG
GGGGGGGGPGGGGGGPGGGGGGGGGGGGGGGPGGGGGGGPGGGGGGGGGG
GGGGGGGGGGGGGGGGGGGGGGGGGGGGGGGGGGGGGGGGGGGGGGGGGG,
NNNNNNNNNNNNNNNNNNNNNNNNNNNNNNNNNNNNNNNNNNNNNNNNNN
NNNNNFNNNNNNNNNNNNNNNNNNNNNNNNNNNNNNNNNNNNNMNNNNNN
NNNNNNNNNNNNNNNNNNNNNNNNNNNNNNNNNNNNNNNNNNNNNNNNNN
NNNNNNNNNNNNNNNNNNNNNNNNNNNNNNNNNNNNNNNNNNNNNNNNNN
NNNNNNNNNNNNNNNNNNNNNNNNNNNNNNNNNNNNNNNNNNNNNNNNNN
NNNNNMNNNNNMNNNNNNNNFNNNNNNNNNNNNNNNNNNNNNNNNNNNNN
NNNNNNNNNNNNNNNNNNNNNNNNNNNNNNNNNNNNNNNNFMNNNNNNNN
NNNNNNNNNNNNNNNNNNNNNNNNNNNNMNNNNNNNNNNNNNNNNNNNNN
NNNNNNNNNNNNNNNNNNNNNNNNNNNNNNNNNNNNNNNNNNNNNNNNNN
NNNNNNNNNNNFNNNNNNNNNNNNNNNNNNNNNNNNNNNNNNNNNNNNNN
NNNNNNNNNNNNNNNNNNNNNNNNNNNNNNNNNNNNNNNNNNNNNNNNNN
NNNNNNNNNNNNNNNNNNNNNNNNNNNNNNNNNNNNNNNNNNNNNNNNNN,
75,
180,
200 300 400 200 200 200 200 200.