50,12,
GGGGGGGGGGGGGGGGGGGGGGGGGGGGGGGGGGGGGGGGGGGGGGGGGG
GGGGGPPPPPPPPPPPPPPPGGGGGGGGGGGGGGGGGGGGGGGGGGGGGG
GGGGGPGGGGGGGGGGGGGPGGGGGGGGGGGPGGGGGGGGGGGGGGGGGG
GGGGGPGGGGGGGGGGGGGPGGGGGGGGGGPPPPPPPGGGGGGGGGGGGG
GGGGGPGGGGGGGGGGGGGPTTTTTTTTTPPGGGGGPGGGGGGGGGGGGG
GGGGGPGGGGGGGGGGGGGPGGGGGGGGGGPPGGGGPGGGGGGGGGGGGG
GGGGGPGGGGGGGGGGGGGPGGGGGGGGGGGPPPPPPGGGGGGGGGGGGG
GGGGGPGGGGGGGGGGGGGPGGGGGGGGGGGGGGGGGGGGGGGGGGGGGG
GGGGGPPPPPPPPPPPPPPPGGGGGGGGGGGGGGGGGGGGGGGGGGGGGG
GGGGGGGGGGGGGGGGGGGGGGGGGGGGGGGGGGGGGGGGGGGGGGGGGG
GGGGGGGGGGGGGGGGGGGGGGGGGGGGGGGGGGGGGGGGGGGGGGGGGG
GGGGGGGGGGGGGGGGGGGGGGGGGGGGGGGGGGGGGGGGGGGGGGGGGG,
NNNNNNNNNNNNNNNNNNNNNNNNNNNNNNNNNNNNNNNNNNNNNNNNNN
NNNNNNNNNNNNNNNNNNNNNNNNNNNNNNNNNNNNNNNNNNNNNNNNNN
NNNNNFNNNNFNNNNNNNNNNNNNNNNNNNNNNNNNNNNNNNNNNNNNNN
NNNNNNNNNNNNNNNNNNNNNNNNNNNNNNNNNNNNNNNNNNNNNNNNNN
NNNNNMNNNNNNNNNNNNNNNNNNNNNNNNNNNNNNNNNNNNNNNNNNNN
NNNNNMNNNNNNNNNNNNNNNNNNNNNNNNNNNNNNNNNNNNNNNNNNNN
NNNNNNNNNNNNNNNNNNNNNNNNNNNNNNNNNNNNNNNNNNNNNNNNNN
NNNNNNNNNNNNNNNNNNNNNNNNNNNNNNNNNNNNNNNNNNNNNNNNNN
NNNNNNNNNNNNNNNNNNNMNNNNNNNNNNNNNNNNNNNNNNNNNNNNNN
NNNNNNNNNNNNNNNNNNNNNNNNNNNNNNNNNNNNNNNNNNNNNNNNNN
NNNNNNNNNNNNNNNNNNNNNNNNNNNNNNNNNNNNNNNNNNNNNNNNNN
NNNNNNNNNNNNNNNNNNNNNNNNNNNNNNNNNNNNNNNNNNNNNNNNNN,
30,
200,
330 990 330 330 660 990 660 990 .