25,12,
GGGGGGGGGGGGGGGGGGGGGGGGG
GGGGGPPPPPPPPPPPPPTTGGGGG
GGGGGPGPGGGGGGGGGGGTGGGGG
GGGGGPPPPPPPPPPPPPPPGGGGG
GGGGGPGPGGGGGGGGGGGPGGGGG
GGGGGPPPPPPPPPPPPPPPGGGGG
GGGGGPGPGGGGGGGGGGGPGGGGG
GGGGGPPPPPPPPPPPPPPPGGGGG
GGGGGPGPGGGGGGGGGGGPGGGGG
GGGGGPTTTTTTTTTTTTTPGGGGG
GGGGGGGGGGGGGGGGGGGGGGGGG
GGGGGGGGGGGGGGGGGGGGGGGGG,
NNNNNNNNNNNNNNNNNNNNNNNNN
NNNNNNNNNNNNNNNNNNNNNNNNN
NNNNNFNNNNNNNNNNNNNNNNNNN
NNNNNNNNNNNNNNNNNNNNNNNNN
NNNNNNNNNNNNNNNNNNNNNNNNN
NNNNNNNNNNNNNNNNNNNNNNNNN
NNNNNNNNNNNNNNNNNNNNNNNNN
NNNNNNNNNNNNNNNNNNNNNNNNN
NNNNNNNNNNNNNNNNNNNMNNNNN
NNNNNNNNNNNNNNNNNNNNNNNNN
NNNNNNNNNNNNNNNNNNNNNNNNN
NNNNNNNNNNNNNNNNNNNNNNNNN,
20,
180,
330 330 330 330 660 660 660 660 .