50,12,
GGGGGGGGGGGGGGGGGGGGGGGGGGGGGGGGGGGGGGGGGGGGGGGGGG
GGGGPPPGPPPGGGGGGGGGGGGGGGGGGGGGGGGGGGGGGGGGGGGGGG
GGGPPGPPPGPPPGGGGGGGGGGGGGGGGGGGGGGGGGGGGGGGGGGGGG
GGGGPPPGPPPGPPGGGGGGGPPPGGGGGGGGGGGPPPGGGGGGGGGGGG
GGGGGGGGGGGGGPPGGGGGPPGPPPTTTTTTPPPPGPPGGGGGGGGGGG
GGGGGGGGGGGGGGPPPPPPPGGGGGGGGGGGGGGPPPGGGGGGGGGGGG
GGGGGGGGGGGGGGGPPGGGGGGGGGGGGGGGGGGGGGGGGGGGGGGGGG
GGGGGGGGGGGGGGGGPPGGGGGGGGGGGGGGGGGGGGGGGGGGGGGGGG
GGGGGGGGGGGGGGGGGPPGGGGPPPGPPPGPPPGGGGGGGGGGGGGGGG
GGGGGGGGGGGGGGGGGGPPGPPPGPPPGPPPGPPGGGGGGGGGGGGGGG
GGGGGGGGGGGGGGGGGGGPPPGPPPGPPPGPPPGGGGGGGGGGGGGGGG
GGGGGGGGGGGGGGGGGGGGGGGGGGGGGGGGGGGGGGGGGGGGGGGGGG,
NNNNNNNNNNNNNNNNNNNNNNNNNNNNNNNNNNNNNNNNNNNNNNNNNN
NNNNFFMNNNNNNNNNNNNNNNNNNNNNNNNNNNNNNNNNNNNNNNNNNN
NNNNNNNNNNNNNNNNNNNNNNNNNNNNNNNNNNNNNNNNNNNNNNNNNN
NNNNNNNNNNNNNNNNNNNNNNNNNNNNNNNNNNNNNNNNNNNNNNNNNN
NNNNNNNNNNNNNNMFNNNNNNNNNNNNNNNNNNNNNNNNNNNNNNNNNN
NNNNNNNNNNNNNNNNNNNNNNNNNNNNNNNNNNNNNNNNNNNNNNNNNN
NNNNNNNNNNNNNNNNNNNNNNNNNNNNNNNNNNNNNNNNNNNNNNNNNN
NNNNNNNNNNNNNNNNNNNNNNNNNNNNNNNNNNNNNNNNNNNNNNNNNN
NNNNNNNNNNNNNNNNNNNNNNNNNNNNNNNNNNNNNNNNNNNNNNNNNN
NNNNNNNNNNNNNNNNNNNNNNNNNNNNNMNNNNNNNNNNNNNNNNNNNN
NNNNNNNNNNNNNNNNNNNNNNNNNNNNNMNNNNNNNNNNNNNNNNNNNN
NNNNNNNNNNNNNNNNNNNNNNNNNNNNNNNNNNNNNNNNNNNNNNNNNN,
35,
180,
660 660 660 660 660 660 660 660.